#####################################
#...........#...........#...........#
#.###.###.###.#########.###.###.###.#
#...#...........................#...#
#.#...#########################...#.#
#.#.#.............#.........*...#.#.#
#.#.########.####.#.####.########.#.#
#.................#.................#
#.###.#.#.######.###.######.#.#.###.#
#.....#.#.........#.........#.#.....#
#.#####.#.##.##.#...#.##.##.#.#####.#
#.....#.#.##.##.## ##.##.##.#.#.....#
#.###.*.........#   #...........###.#
#...###.#.##.##.#####.##.##.#.###...#
###.#.....##.##...#...##.##.....#.###
....#.#.#.......#.#.#.......#.#.#....
###.#.#.#######.#.#.#.#######.#.#.###
#...#...........#.#.#...........#...#
#.###.#########...#...#########.###.#
#...#.#...#.....#####.....#...#.#...#
###.....#...#.#.......#.#...#.....###
#...#.#...###.##.#.#.##.###...#.#...#
#.###.#.####...#.#.#.#...####.#.###.#
#............#....*....#............#
#.######.##.######.######.##.######.#
#.#....#....#....#.#....#....#....#.#
#...##...##...##.....##...##...##...#
#####################################
