###########
#.........#
#.##.#.##.#
...........
##.## ##.##
##.#   #.##
#*.#####..#
#.##...##.#
#....#..*.#
###########
