###########.###########
#.........#.#.....*...#
#.###.###.....###.###.#
#.###.#...#.#...#.###.#
#.###.#.#.....#.#.###.#
#..#....### ###....#..#
##.#.#.###   ###.#.#.##
.....#.#########.#.....
##.#.#.##.....##.#.#.##
#..#...*..###......#..#
#.###.#.#######.#.###.#
#.###.#...###...#.###.#
#.###.###.....###.###.#
#.........#.#....*....#
###########.###########
