###########
#....*...F#
#.#.#.#.#.#
....._.....
##.## ##.##
##.#   #.##
#..#####..#
#.##.F.##.#
#*...#...*#
###########
