###########.###########
#.........#.#.....*..F#
#.###.###.....###.###.#
#.###.#...#.#...#.###.#
#.###.#.#.._..#.#.###.#
#..#....### ###....#..#
##.#.#.###   ###.#.#.##
.....#.#########.#.....
##.#.#.##.....##.#.#.##
#..#...*..###..F...#..#
#.###.#.#######.#.###.#
#.###.#...###...#.###.#
#.###.###.....###.###.#
#...F.....#.#....*....#
###########.###########
